12 12
# # # # # # # # # # # #
# . . . # . . . . . . #
F . # . # . # # # # . #
# # # . # . . . . # . #
# . . . . # # # . # . S
# # # # . # . # . # . #
# . . # . # . # . # . #
# # . # . # . # . # . #
# . . . . . . . . # . #
# # # # # # . # # # . #
# . . . . . . # . . . #
# # # # # # # # # # # #